
R 1000 1000
NO ./test_north_wall.xpm
SO ./test_south_wall.xpm
WE ./test_east_wall.xpm
EA ./test_east_wall.xpm
S ./test_sprite.xpm
F ./test_floor.xpm
C ./test_ceil.xpm

1111111111111111111111111111111111111111111111111
1000001000000001000000000000000000001000000001001
1001001001111001001111111001111111001111001001001
1001000001000001001000020001000000001000001000001
1001111111111111001001111111001111111001111111001
1000020000001000001001000001000000001001000001001
1111111111001111111001111001111111001001111001001
1001020001001000000001002001000001020001000001001
1001001001001001111111001111001001111111001111001
1001001001000001000001001000001002000001000000001
1001001001111111001001001001111111111001001111111
1000001001000200001000001001000002000001000000001
1111111001001001111001111001001111111111111111001
1000200001001002001001020001001000000001000000001
1001111111001111001111001111001001111001001111111
1000000000000001000N00000001000000001000000000001
1111111111111111111111111111111111111111111111111
