R 2000 2000

  SO ./test_south_wall.xpm
 WE ./test_east_wall.xpm
 EA ./test_east_wall.xpm
 F        ./test_ceil.xpm
   S  ./test_sprite.xpm
 C   255,100,0
NO ./test_north_wall.xpm

         1111111111111111111111111111111111111111111
          100N000000000000000000000000000000000000001
         1111000111111111111110000000000000000000111111
         1111101             100000000000000000000000001
         1111101             100000000000000000000000001
         1111101             100000000220000000000000001
         1111101             100000000220000000000000001
         1111101             100000000220000000000000001
         1111101             100000000220000000000000001
         1111101             100000000000000000000000001
         1111101             100000000200222200000000001
         1111101             100000000000222200000000001
         1111101             100000000000222200000000001
         1111101             100000000000222200000000001
         1111101             100000200000000000000000001
         1111101             100000000000000000000000001
         1111101             100000000000000000000000001
         1111101             100000000000000000000000001
         1111101             100000000000000000000000001
         1111101             100000000000000000000000001
         1111101             100000000000000000000000001
         1111101             100000000000000000000000001
         1111101             100000000000000000000000001
         1111111111111111111111111111111111111111111111 
