      R   1920 1080
   NO ./test_north_wall.xpm
  SO ./test_south_wall.xpm
 WE ./test_east_wall.xpm

 EA ./test_east_wall.xpm
   F  0,255,0   
   C    255,250,0   
   S  ./test_sprite.xpm


         1111111111111111111111111111111111111111111
          100N001000000000000000000000000000000000001
         1111000111111111111110000000000000000000111111
         1111101             100000000000000000000000001
         1111111111111111111111111111111111111111111111 

